4 7 7 7 7 7 7 0 0 7 7 7 7 7 7 8
10 2 2 2 2 2 0 1 1 0 2 2 2 0 0 3
10 2 2 2 0 0 0 1 1 0 2 2 2 2 2 3
10 2 2 0 0 0 0 1 1 2 2 0 2 2 0 3
10 0 2 2 0 0 1 1 1 1 0 0 0 0 0 3
0 1 1 1 1 1 1 1 1 1 1 1 1 1 1 0
0 1 1 1 1 1 1 1 1 1 1 1 1 1 1 0
10 0 0 0 0 0 1 1 1 1 0 2 0 0 0 3
10 2 0 0 0 2 0 1 1 0 0 2 0 0 0 3
10 2 2 2 2 0 0 1 1 0 0 2 2 2 0 3
10 2 2 2 2 2 0 1 1 0 2 2 2 2 2 3
9 5 5 5 5 5 5 12 13 6 6 6 6 6 6 11
